NO sprites/Bricks.xpm
EA sprites/Castle_Wall.xpm
WE sprites/Metal.xpm
SO sprites/Wood.xpm

F 252,253,255
C 1,2,2

1111111111
1000000001
1000011101
1000000101
1000000101
1010000001
1000000001
1010100001
1000000001
1111111111
